[
  { "x": 15, "y": 48 },
  { "x": 24, "y": 60 },
  { "x": 13, "y": 70 },
  { "x": 32, "y": 66 },
  { "x": 27, "y": 80 },
  { "x": 40, "y": 56 },
  { "x": 44, "y": 72 },
  { "x": 40, "y": 86 },
  { "x": 55, "y": 78 },
  { "x": 63, "y": 62 },
  { "x": 71, "y": 68 },
  { "x": 82, "y": 72 },
  { "x": 88, "y": 60 }
]
