[
  { "x": 16, "y": 62 },
  { "x": 25, "y": 70 },
  { "x": 13, "y": 78 },
  { "x": 31, "y": 76 },
  { "x": 22, "y": 84 },
  { "x": 37, "y": 63 },
  { "x": 34, "y": 84 },
  { "x": 45, "y": 72 },
  { "x": 45, "y": 87 },
  { "x": 57, "y": 84 },
  { "x": 63, "y": 62 },
  { "x": 71, "y": 67 },
  { "x": 66, "y": 78 },
  { "x": 79, "y": 63 },
  { "x": 87, "y": 71 },
  { "x": 82, "y": 82 }
]
